10
1 1 2 1 1 2 2
########################
#G#######t------------k#
#K#######-----#####----#
#-------T---H-F--------#
###############-########
#---------------------t#
#K#############--------#
#---------##############
#P-------k##############
########################