13
3 1 1 2 1 2 

0 false false true false false 
#################
#######GK########
########K########
#####------######
###k--#-##---k###
#######T#########
######-P--t######
######-##########
######-##########
######-##########
#-----------#####
###--------######
#################
